7 7
5 0

p000000
0000000
0000c0s
0000000
0000000
0000000
xx00000

32 32 32 32 32 32 32 
32 32 32 119 32 32 32 
119 119 119 119 32 32 32 
32 32 32 32 32 32 32 
32 32 32 32 32 32 32 
32 32 32 32 32 128 119 
32 32 32 32 32 119 119 