20 20
19 82

00000000000000000000
000xxxx0000000000x0
00000000000000000000
00000000000000000000
00p00000000000000000
00000000000000000000
00000000000s00000000
00000000000s00000000
0000000000s00000000
00000000000s00000000
0000000000000000000
00000000000c00000000
0000x000000000000000
00000000000c00000000
00c000000000000ss000
00000000000000000000
0000000000000s000000
000000c0000000000000
0000000000000s000000
00000000000000000000

144 144 119 119 119 119 119 144 119 119 119 119 119 119 119 119 119 119 119 119 
144 144 32 119 32 32 32 32 119 32 32 32 32 32 32 32 32 32 32 119 
144 144 32 119 144 144 144 144 119 32 32 119 119 119 119 32 32 32 32 119 
144 144 32 32 32 32 32 32 32 32 32 32 32 32 119 32 32 32 32 119 
144 144 32 32 32 32 32 32 32 32 32 32 32 32 119 32 32 32 32 119 
144 32 32 32 32 32 32 119 119 119 119 119 119 32 32 32 32 32 32 119 
119 32 32 32 32 32 32 144 32 32 32 32 119 32 32 32 32 32 32 119 
119 32 32 32 32 32 32 144 32 32 32 32 32 32 32 32 32 32 32 119 
119 32 119 119 32 32 32 144 32 32 32 32 32 32 32 32 32 32 32 119 
119 32 32 119 32 119 32 144 32 32 32 32 119 32 32 119 119 32 32 119 
119 119 32 119 32 119 32 119 119 119 119 119 119 32 32 32 32 32 32 119 
119 32 32 119 119 119 32 32 32 32 32 32 119 32 119 32 32 119 32 119 
119 32 32 119 32 32 32 32 32 32 32 32 119 32 32 32 32 32 32 119 
119 32 32 119 119 119 32 32 32 32 32 32 119 32 32 32 32 32 32 119 
119 32 32 119 32 32 32 119 119 119 119 119 119 32 32 32 32 32 32 119 
119 32 32 119 32 32 32 32 32 32 32 32 32 32 32 32 32 32 32 119 
119 32 32 119 32 119 32 119 32 32 32 32 32 32 32 32 32 32 32 119 
119 32 32 119 32 32 32 32 32 32 32 32 32 32 32 32 32 32 32 119 
119 32 32 119 32 119 32 119 32 32 32 32 32 32 32 32 32 119 128 119 
119 119 119 119 119 119 119 119 119 119 119 119 119 119 119 119 119 119 119 119 