60 10
9 61

000000000000000000000000000000000000000000000000000000000000
0p000c00000000xcx0ccc0000000000000000000000000000000000000
0000x0000000000000000000000000000000000000000000000000000000
0000000000s0000000000000000000000000000000000000000000000000
00000c00000s0000000000000x000000000000000000000000000000000
000000000x0000000000000000000000000000000000000000000000000
000000000000000000000000000000000000000000000000000000000000
00000000000000x00000000ss0000000000000000000000000000000000
000c000000000000xcx0000ss0000000000000000000000000000000000
000000000000000000000000000000000000000000000000000000000000

119 119 119 119 119 119 119 119 119 119 119 119 119 119 119 119 119 119 119 119 119 119 119 119 119 119 119 119 119 119 119 119 119 119 119 119 119 119 119 119 119 119 119 119 119 119 119 119 119 119 119 119 119 119 119 119 119 119 119 119 
119 32 119 32 32 119 32 32 32 32 32 32 32 32 32 119 32 32 32 119 32 32 32 119 32 32 32 32 32 32 32 32 32 32 32 32 32 32 32 32 32 32 32 32 32 32 32 32 32 32 32 32 32 32 32 32 32 32 32 119 
119 32 32 32 32 119 119 119 32 119 119 119 119 32 32 119 144 32 144 119 144 32 144 119 32 32 32 32 32 32 32 32 32 32 32 32 32 32 32 32 32 32 32 32 32 32 32 32 32 32 32 32 32 32 32 32 32 32 32 119 
119 32 119 119 119 119 32 32 32 32 32 32 119 32 32 32 32 32 32 32 32 32 32 32 32 32 32 32 32 32 32 32 32 32 32 32 32 32 32 32 32 32 32 32 32 32 32 32 32 32 32 32 32 32 32 32 32 32 32 119 
119 32 32 32 32 32 32 32 32 119 119 32 119 32 32 32 32 32 32 32 32 32 32 32 32 32 32 32 32 32 32 32 32 32 32 32 32 32 32 32 32 32 32 32 32 32 32 32 32 32 32 32 32 32 32 32 32 32 32 119 
119 32 32 32 32 32 32 32 32 32 119 32 119 32 32 32 32 32 32 32 32 32 32 119 32 32 32 32 32 32 32 32 32 32 32 32 32 32 32 32 32 32 32 32 32 32 32 32 32 32 32 32 32 32 32 32 32 32 32 119 
119 32 32 32 32 32 32 32 32 119 119 32 119 32 32 32 32 32 32 119 32 119 119 119 119 119 119 32 32 32 32 32 32 32 32 32 32 32 32 32 32 32 32 32 32 32 32 32 32 32 32 32 32 32 32 32 32 32 32 119 
119 32 32 32 32 144 144 144 32 32 32 32 32 32 32 119 144 32 144 119 32 32 32 32 32 32 119 32 32 32 32 32 32 32 32 32 32 32 32 32 32 32 32 32 32 32 32 32 32 32 32 32 32 32 32 32 32 32 32 119 
119 32 32 32 144 144 144 144 144 144 144 144 32 32 32 119 32 32 32 119 32 32 32 32 32 32 119 32 32 32 32 32 32 32 32 32 32 32 32 32 32 32 32 32 32 32 32 32 32 32 32 32 32 32 32 32 32 32 128 119 
119 119 119 119 144 144 144 144 144 144 144 144 144 144 119 119 119 119 119 119 119 119 119 119 119 119 119 119 119 119 119 119 119 119 119 119 119 119 119 119 119 119 119 119 119 119 119 119 119 119 119 119 119 119 119 119 119 119 119 119 