10 10
9 30

000000cc00
000000cc00
0000000000
p00s0s0000
0000s00000
0000s00000
0000000000
000000x000
0000000000
0000000000

32 32 32 32 32 32 32 32 32 32 
32 32 32 32 32 32 32 32 32 32 
32 32 119 119 119 119 119 32 32 32 
32 32 144 32 32 32 119 32 32 32 
32 32 144 32 32 32 119 32 32 32 
32 32 144 32 32 32 119 32 32 32 
32 32 144 119 119 119 119 32 32 32 
32 32 32 32 32 32 32 32 32 32 
32 32 32 32 32 32 32 32 32 32 
32 32 32 32 32 32 32 32 32 32 